11111111111
1B000L01011
100CS0L0B01
10S00E0SCN1
10S0000S001
1Z00BBC1011
1P000001001
11111111111
