111111111111111111111111111
100LB000000B000B00000000BE1
100000000C00000000C000000B1
111100000000C00000000000001
10B0000C000L0C00C00C0B00001
1000C000000S000000000000001
1B00000C000000B000C0000L001
1000000C0000C00S0001100B001
1B00000B0000C0B0110B0000Z01
100000C00S000000S1000011111
10N000C00S000000010S00S0S01
1P00000000000000010S00S0001
111111111111111111111111111
