1111111
1C000L1
1010101
10SES01
10SSSS1
1P00001
1111111
