11111
11111
11111
11111
1PSC1
1SSC1
11001
11S01
1ELL1
11111
