11111111111111111111111111111111111111
10SCL0N100000000000000K111100000000001
10B10B01000000000000011111000000000001
100B0101000000001111111110000000C00001
1000B001000000000111111110000000000001
111000B00100000000111110000S0000000001
11111111111110000BBBB000B0000000000001
111111111111111111111000000000L0000001
11111111111111111111111100L00000C00001
10E0Z00000000000000111110000P000000001
10000000000000000000000B00000000000001
111000000000000000000011000000L0000001
11111111111111111000001100000000000001
11111111111111111111101100000000000001
11111111111111111111111111111111111111
