11111111
1W000001
11110001
1PSLCE01
10000001
10000001
11111111
