111111111111111111111111111111
100000K000000E1000100000001C11
101111101111111010101111101011
1000001C00C01000101C00C0101011
111110111110111110111110101011
10C010000010001010100CC0101011
101111111010101010101111101011
10001P000010100010001C100C1011
101010111110111111111010111011
101C0C000000000000000000000011
111111111111111111111111111111
