111111111111111111111111
10C00100000C0000C0000001
100C0100000C11C1C1110001
100C00000000000100000001
100001111111100100111111
1C0001000000100100111001
111111010011000100000001
1CCCC0000000010111111101
1CP111110000C1C1000000E1
111111111111111111111111
