11111111111
1P1ELLL0001
101111101S1
101C00101S1
101010101S1
1S0010C0001
11111111111
