111111111
1BLLSLLB1
1W0111ZW1
1S1PCE1S1
1WN1110W1
1BLLKLLB1
111111111
