1111111
1P00101
1N0SC01
100SCL1
1E001Z1
1111111
