111111111111111111111111111111111111111111
1C00000110000011L10000000100011110000000C1
100010000000111111100000100100000000000001
100000000000011111000010001000100100000001
100000001000000000000000000011001110000001
110000000000000100000000000110011100111111
11110000000000000000000000111S111100000001
11L110000000LL00000000011111SPS11111000001
111100000000LL000000000011L11E111100000001
1100000000000000000000000011111110000L0001
100000000011111000000010000011100000000001
100000011111111111100000000001000010000001
100L000000011111L1111100000000000111100001
100000000000000011110000000000001111100001
1000000001100000000000000000000001L1110001
11111001111110000000000000LL00000011100001
1000001110C11100000C000000LL00000001000001
100011110011111000000000000000000000000001
1C000000011L111000000110000000000000000011
111111111111111111111111111111111111111111
