1111111
1C0E0C1
1011101
1000001
1C1P1C1
1111111
