11111111111111111111
1PCWSSSSBSSS1SSS1SS1
1CCCSBSSSLLLBLLL1LL1
1S00000B000011000001
10N0B000W000B0W001B1
10W0000B00B0W0BB0101
100110LB0001100001B1
1000S0001110011000B1
100111100100011000B1
1011000000W00000S001
100K1001100110Z00001
10L010000L00000100E1
100W000110001000C001
100W01S00011000C0001
100100000L0000000001
11111111111111111111
