1111111111
1E00l00001
11111111S1
10B0000001
1S11111111
10000L00P1
1111111111
