111111111111111111111111111111
100000000000000000000000000001
100000000000000000000000000001
10000000E000000000000000000001
100000000000000000000000000001
10000000000S00L000000000000001
100P0000000C0000C0000000000001
100000000L00000000000000000001
100000000000000000000000000001
100000000000000000000000000001
111111111111111111111111111111
